11111111111111111111
10000000000001110001
10011100000000000001
10000000011000000001
10000000000000111001
10000001100000000001
10000000000000000001
10001111111111100001
10000000000000000001
10000000001111111111
11111100000000000001
10000000000000000001
10011100000111111101
10000000000000000001
11111111111111111111