11111111111111111111
10000000000001110001
10000000000000000001
10001111111000000001
10000000000000110001
10000000000000000001
10000000000000000001
10001111111111100001
10000000000000000001
10000000000000000001
11111000000000011111
10000000000000000001
10000001111110000001
10000000000000000001
11111111111111111111